X X X X X X X X X X X X X X
X X X X X X X X X X X X X X
X X X X X X X X X X X X X X
X X X 0 1 1 1 1 1 1 0 X X X
X X X 1 + e . . . + 1 X X X
X X X 1 . . . . . . 1 X X X
X X X 1 . . . . . . 1 X X X
X X X 1 . . . . . . 1 X X X
X X X 1 . . . . . . 1 X X X
X X X 1 . . . . . . 1 X X X
X X X 1 + a b c d + 1 X X X
X X X 0 1 1 1 1 1 1 0 X X X
X X X X X X X X X X X X X X
X X X X X X X X X X X X X X
X X X X X X X X X X X X X X