0 0 0 0 0 0 0 0 0 0 0 0 0 0 0 0 0 0 0 0
0 0 1 1 0 1 0 1 1 0 0 1 0 0 0 0 1 1 1 0
0 0 1 1 1 1 0 1 1 1 1 1 0 1 0 0 1 0 1 0
0 1 1 1 1 1 0 0 1 1 1 1 1 1 1 1 1 0 1 0
0 1 0 1 1 1 1 1 c a 1 1 1 0 1 0 0 1 1 0
0 1 1 0 0 1 0 0 1 0 1 1 0 0 1 0 0 1 1 0
0 1 0 0 1 0 1 1 0 1 1 1 1 1 1 0 1 1 1 0
0 1 1 1 1 1 1 1 1 1 0 0 1 1 0 1 0 1 0 0
0 1 1 0 1 0 1 0 1 1 1 0 0 0 1 d 1 1 1 0
0 0 0 1 1 1 1 0 1 1 1 1 1 1 1 1 0 1 1 0
0 0 1 0 1 1 0 1 1 1 1 1 1 1 b 0 0 1 0 0
0 1 0 1 1 0 1 0 0 0 0 1 0 0 1 0 1 1 1 0
0 1 1 0 2 1 1 1 0 0 1 1 1 1 1 1 1 0 1 0
0 1 1 1 1 1 1 1 0 1 1 1 1 1 0 1 1 0 0 0
0 0 0 0 0 0 0 0 0 0 0 0 0 0 0 0 0 0 0 0